111111111111111111111111111111111111111111111111111111111
1P0000000000000000000001000000000000000000000000011111111
11111111111111111111110001111111111111111111111C011111111
11111111111111111111111111111100C00C000111111110000000011
111111111111111111111111111111011111110111111111111111011
1E000000C00C00C00C00C00C00C00C001111110000C00000C00000001
111111111111111111111111111111111111111111111111111111111