11111111111111111111111111111
10C0C000C0C100000000000000001
10100101001000001010010010101
10110011101010100010010E10101
1P0C10CC100CCCCCCCCC000000001
11111111111111111111111111111
