111111111111111111111111111111111111111
1P0100010111111100011111111111111100C01
1100010C0111100001001111C10000111010011
1C0101011111101111100111000010111110111
110001111111101000010111111000111000011
10011110CC01100011010001000011100011111
110000101101111100011100011000101011111
101110000000011001110001111110001110111
111111111111010011110111110000100100101
111110001000011011110000110110010001101
11111010001110001111111011000C111111101
111000111100001111110000111110000111111
111011000101111C11C10111000111111111001
111000010001110001000100010011000111011
11111C111011110100011001111001010010001
1111111C1001110011100011111100011000101
1111111000011110000011111111111111111E1
111111111111111111111111111111111111111